GGGGGGGGGG
P........P
P........P
P........P
P........P
P........P
P........P
P........P
PLl..Bb..P
..........
..........
..........
..pppppp..