GGGGGGGGGG
P........P
P........P
P........P
P........P
P........P
P........P
P........P
PLB.B....P
..........
..........
..........
.pppppppp.

