GGGGGGGGGG
P........P
P........P
P........P
P........P
P........P
P........P
P........P
PLl.B....P