GGGGGGGGGG
P........P
P........P
P........P
PLl....b.P
P........P
PLB......P
P........P
P........P
PLB..l.b.P
..........
..........
.pppppppp.