GGGGGGGGGG
P........P
P........P
P........P
P........P
P........P
P........P
PL..B....P
..........
..........
....pp....