GGGGGGGGGG
P........P
P........P
P........P
P........P
P........P
P........P
P........P
PLB....b.P
..........
..........

